***************************
*S     *                  *
****** ********* **********
*                         *
*********** ************* *
*                         E
***************************