*************************************************
*S             *                                *
*** ** ******* ******************************** *
*** **    **** *                              * *
*** ********** * ****************************** *
**   ***** *** *                                *
** *     * *** ******************************** *
** ***** * ***   *   *          *               *
** ** ** *     * * * * * ****** * ************* *
**       ******* * * * * **** * * *    **    ** *
******** *         * * *      * *   **    ** ** *
******** *********** * ******** *************** *
**                 *               ******* * ** *
** *************** *************** ******* * ** *
** *             * *        *****   ****** * ** *
** * ******** ** * * ****** ****  *  ***** * ** *
** * ******** ** * *   **   ***  ***  **** * ** *
** * *        ** * * ****** **  *****  *** * ** *
**   *********** * *        *  ** * **  ** * ** *
** *             * * ******** **  *  ** ** * ** *
** *************** * ******** ** *** ***** * ** *
**                 *                            E
*************************************************