*************************************************************************
*************************************************************************
             *                               *            *         *   *
************ ********************** ******** * * *** ****** **** ** * * *
** **   * ** **                       *    * * * * *      * **** ** * * *
** ** * * ** ** ******************* * * **** * * * * ******    * ** * * *
** ** * * ** ** **********          * *      * * *       ***** *    * * *
** ** * * ** ** **       * ******** ********** * ******* *     ****** * *
** ** * * ** ** ** ***** * *      * *          *       * * ***    *   * *
** ** * *  * ** ** *   * * * **** * * ** * *********** * ******** * *** *
** ** * ** * ** ** *** * * ****** * * ** *    *      * *       **   *   *
**    * ** * ** **     *          * * *  * ** * **** * * ** ***** ***** *
** ** * ** * ** ** **************** * **** ** * * ** * * ** *         * *
** ** * **              * ** ** **  *    * ** * *    * * ** * ********* *
** ** * ******* ** ****** ** ** ***** **** *  * ****** * ** * *S*       *
** ** *       * ** ****** **       ** ** * ****        * ** * * * ** ** *
** ** ******* * **        ** ** **    **      ********** **   * * ** ** *
** ** ******* * *************** ***** ** ********* ************ * ** ** *
** **       * *                 *        *    **** **         * * ** ** *
** ********** ******** **************** ** **    * ** ******* * * ** ** *
** ** ********* ***      * ****       *    ** ** * **       * *    * ** *
** ** *       * *** **** *    * ***** ******* ** * ******** * * ** * ** *
** ** * ** ** * *** ** * * ** *    ** **      ** *        * * * ** * ** *
** ** * ** ** *     ** * * ** **** ** ** **** ** * * ****** * * ** **** *
** ** *  * ** * ** *** *   **    * ** ** *  * ** * * ***  * * * *  *    *
** ** **** ** * *      *   *** *** ** ** ** * *  * * *** ** * * *********
**         ** * ************** ****** **    * * ** *   * ** * *     *   *
** ** ******* *                     * ******* * ** * *** ** * * ***** * *
** **       * ******** **************         * ** *        * *       * *
** ********** ******** ************************ ** ******** * ********* *
**          *                                 *             *         *  E
*************************************************************************
*************************************************************************



