*********************************************************************
*********************************************************************
*S       *                               *            *         *   *
******** ********************** ******** * * *** ****** **** ** * * *
*   * ** **                       *    * * * * *      * **** ** * * *
* * * ** ** ******************* * * **** * * * * ******    * ** * * *
* * * ** ** **********          * *      * * *       ***** *    * * *
* * * ** ** **       * ******** ********** * ******* *     ****** * *
* * * ** ** ** ***** * *      * *          *       * * ***    *   * *
* * *  * ** ** *   * * * **** * * ** * *********** * ******** * *** *
* * ** * ** ** *** * * ****** * * ** *    *      * *       **   *   *
* * ** * ** **     *          * * *  * ** * **** * * ** ***** ***** *
* * ** * ** ** **************** * **** ** * * ** * * ** *         * *
* * **              * ** ** **  *    * ** * *    * * ** * ********* *
* * ******* ** ****** ** ** ***** **** *  * ****** * ** * * *       *
* *       * ** ****** **       ** ** * ****        * ** * * * ** ** *
* ******* * **        ** ** **    **      ********** **   * * ** ** *
* ******* * *************** ***** ** ********* ************ * ** ** *
*       * *                 *        *    **** **         * * ** ** *
* ******* ******** **************** ** **    * ** ******* * * ** ** *
* ********* ***      * ****       *    ** ** * **       * *    * ** *
* *       * *** **** *    * ***** ******* ** * ******** * * ** * ** *
* * ** ** * *** ** * * ** *    ** **      ** *        * * * ** * ** *
* * ** ** *     ** * * ** **** ** ** **** ** * * ****** * * ** **** *
* *  * ** * ** *** * * **    * ** ** *  * ** * * ***  * * * *  *    *
* **** ** * *      *   *** *** ** ** ** * *  * * *** ** * * *********
*      ** * ************** ****** **    * * ** *   * ** * *     *   *
* ******* *                     * ******* * ** * *** ** * * ***** * *
*       * ******** **************         * ** *        * *       * *
******* * ******** ************************ ** ******** * ********* *
*       *                                 *             *         * E
*********************************************************************
*********************************************************************