***************************
*S       *    *      **   *
******** * ** * * **  * * *
**     * **** *** ***** ***
** * * *                  *
** * * *********** ****** *
** * * *         * *   ** *
** * * * ********* * * ** *
** * * * ********* *** ****
**                     ** *
************** ********** *
*                         *
* **************** ********
* *****   ***    * *      *
*       *     ** *   **** E
***************************